todays_date,total_hospitalized_covid_confirmed_patients,total_hospitalized_suspected_covid_patients,total_hospitalized_covid_patients,total_hospital_beds,total_icu_covid_confirmed_patients,total_icu_suspected_covid_patients,icu_available_beds
2023-05-12,1149,97,1246,66266,150,13,2141
2023-05-11,1176,106,1282,66622,132,15,2110
2023-05-10,1182,103,1285,66525,116,10,2049
2023-05-09,1172,81,1253,66103,120,6,2161
2023-05-08,1188,91,1279,65258,131,11,2357
2023-05-07,1217,92,1309,65330,131,12,2218
2023-05-06,1144,97,1241,65473,140,14,2161
2023-05-05,1163,94,1257,66260,146,14,2134
2023-05-04,1195,115,1310,66649,134,17,2089
2023-05-03,1227,106,1333,66685,137,9,2028
2023-05-02,1239,109,1348,66214,141,11,2051
2023-05-01,1282,109,1391,65803,133,16,2273
2023-04-30,1315,104,1419,65381,142,20,2130
2023-04-29,1247,118,1365,65991,147,17,2140
2023-04-28,1267,110,1377,66777,149,12,2235
2023-04-27,1316,108,1424,66767,159,13,2037
2023-04-26,1318,112,1430,66850,158,17,1970
2023-04-25,1347,123,1470,66331,169,16,1970
2023-04-24,1426,145,1571,65898,148,26,2146
2023-04-23,1466,132,1598,65563,156,21,2127
2023-04-22,1337,125,1462,66080,167,23,2062
2023-04-21,1413,138,1551,66652,172,17,2012
2023-04-20,1334,148,1482,66708,143,21,1974
2023-04-19,1361,139,1500,66766,143,21,2021
2023-04-18,1469,143,1612,66332,145,19,1977
2023-04-17,1464,148,1612,66054,149,29,2147
2023-04-16,1473,162,1635,65602,162,24,2092
2023-04-15,1417,143,1560,65864,159,19,1987
2023-04-14,1484,156,1640,66601,179,19,1946
2023-04-13,1455,174,1629,66707,178,18,1947
2023-04-12,1437,195,1632,66677,184,25,1931
2023-04-11,1470,212,1682,66225,164,28,1946
2023-04-10,1485,211,1696,65854,173,33,2097
2023-04-09,1484,266,1750,65408,179,36,2008
2023-04-08,1413,324,1737,66070,178,40,1917
2023-04-07,1494,343,1837,66580,184,37,1886
2023-04-06,1569,362,1931,66749,181,37,1980
2023-04-05,1561,419,1980,66598,171,45,1520
2023-04-04,1553,393,1946,66266,177,43,1604
2023-04-03,1539,409,1948,65705,176,55,2056
2023-04-02,1562,410,1972,65421,181,50,2012
2023-04-01,1494,403,1897,66065,184,45,1956
2023-03-31,1593,422,2015,66571,179,44,1878
2023-03-30,1598,430,2028,66816,194,45,1805
2023-03-29,1590,462,2052,66933,187,48,1853
2023-03-28,1625,437,2062,66359,177,40,1926
2023-03-27,1694,399,2093,65868,196,49,2075
2023-03-26,1708,394,2102,65535,191,43,2051
2023-03-25,1705,411,2116,66071,191,44,1999
2023-03-24,1725,420,2145,66685,187,45,1967
2023-03-23,1762,411,2173,66919,204,41,1889
2023-03-22,1823,414,2237,66898,214,47,1900
2023-03-21,1892,451,2343,66406,222,56,1866
2023-03-20,1938,439,2377,65971,237,50,2023
2023-03-19,1931,443,2374,65618,233,49,1998
2023-03-18,1967,441,2408,66040,221,50,1847
2023-03-17,1974,452,2426,66666,233,60,1819
2023-03-16,2026,463,2489,66905,244,56,1807
2023-03-15,2093,444,2537,66950,252,52,1766
2023-03-14,2197,467,2664,66529,277,53,1813
2023-03-13,2217,479,2696,66175,278,55,2003
2023-03-12,2219,475,2694,65803,248,52,1937
2023-03-11,2202,466,2668,66222,247,50,1849
2023-03-10,2289,490,2779,66751,281,53,1814
2023-03-09,2351,483,2834,66943,290,57,1796
2023-03-08,2375,443,2818,67092,279,57,1775
2023-03-07,2455,491,2946,66588,275,58,1817
2023-03-06,2336,463,2799,66188,262,53,1899
2023-03-05,2485,467,2952,65829,285,71,1860
2023-03-04,2447,454,2901,66315,293,60,1779
2023-03-03,2519,479,2998,66898,303,65,1738
2023-03-02,2453,473,2926,66945,289,62,1723
2023-03-01,2506,461,2967,67136,296,63,1626
2023-02-28,2517,458,2975,66661,311,58,1816
2023-02-27,2530,469,2999,66087,310,62,1892
2023-02-26,2548,464,3012,65616,295,49,1853
2023-02-25,2483,501,2984,66198,269,48,1743
2023-02-24,2516,510,3026,66872,307,50,1795
2023-02-23,2583,525,3108,66922,305,62,1840
2023-02-22,2607,521,3128,67045,293,66,1788
2023-02-21,2573,476,3049,66334,278,62,1892
2023-02-20,2451,483,2934,65940,292,58,1930
2023-02-19,2406,487,2893,65693,283,63,1888
2023-02-18,2317,478,2795,66051,265,58,1771
2023-02-17,2509,476,2985,66679,292,59,1746
2023-02-16,2525,491,3016,67056,282,60,1765
2023-02-15,2541,466,3007,67021,296,52,1732
2023-02-14,2529,489,3018,66526,282,56,1712
2023-02-13,2510,470,2980,66185,287,57,1898
2023-02-12,2462,489,2951,65773,258,61,1807
2023-02-11,2448,503,2951,66363,258,54,1716
2023-02-10,2480,518,2998,66969,279,68,1778
2023-02-09,2485,488,2973,66967,302,58,1722
2023-02-08,2477,497,2974,67095,275,63,1761
2023-02-07,2578,508,3086,66631,268,57,1804
2023-02-06,2511,513,3024,66136,280,62,1951
2023-02-05,2516,517,3033,65747,272,60,1929
2023-02-04,2385,474,2859,66291,276,61,1804
2023-02-03,2404,494,2898,66832,270,66,1776
2023-02-02,2476,500,2976,67028,267,64,1746
2023-02-01,2484,478,2962,67106,293,56,1743
2023-01-31,2562,480,3042,66756,283,54,1802
2023-01-30,2480,473,2953,66291,266,60,1984
2023-01-29,2559,460,3019,65796,300,57,1898
2023-01-28,2459,459,2918,66421,301,57,1780
2023-01-27,2600,481,3081,66955,337,60,1819
2023-01-26,2694,486,3180,67148,352,51,1736
2023-01-25,2695,483,3178,67098,370,52,1816
2023-01-24,2736,472,3208,66563,406,41,1763
2023-01-23,2769,515,3284,66267,369,64,1977
2023-01-22,2840,493,3333,65881,363,51,1937
2023-01-21,2863,489,3352,66491,353,58,1815
2023-01-20,3117,501,3618,67040,396,63,1791
2023-01-19,3168,499,3667,66946,385,56,1838
2023-01-18,3372,467,3839,67150,378,52,1863
2023-01-17,3478,497,3975,66119,412,58,2059
2023-01-16,3500,496,3996,65752,425,70,2130
2023-01-15,3500,454,3954,65435,445,52,2128
2023-01-14,3534,484,4018,65722,429,51,1892
2023-01-13,3723,502,4225,67116,459,48,1798
2023-01-12,3794,527,4321,67060,490,57,1745
2023-01-11,4025,519,4544,67348,483,49,1764
2023-01-10,4081,563,4644,66850,482,52,1724
2023-01-09,4159,634,4793,66501,487,66,1832
2023-01-08,4155,593,4748,66258,485,57,1783
2023-01-07,3933,625,4558,66561,474,54,1676
2023-01-06,4365,622,4987,67110,506,55,1710
2023-01-05,4455,593,5048,67052,504,49,1727
2023-01-04,4547,582,5129,67133,508,57,1816
2023-01-03,4648,618,5266,66518,524,59,1881
2023-01-02,4605,576,5181,66223,528,56,1896
2023-01-01,4512,552,5064,65899,493,55,1998
2022-12-31,4467,571,5038,66235,500,55,1854
2022-12-30,4616,570,5186,66542,532,55,2011
2022-12-29,4619,612,5231,66630,517,58,1978
2022-12-28,4561,613,5174,66714,537,55,2016
2022-12-27,4432,565,4997,65836,530,60,2147
2022-12-26,4416,554,4970,65429,510,64,2168
2022-12-25,4175,550,4725,64982,505,53,2205
2022-12-24,4275,551,4826,65659,550,70,2025
2022-12-23,4467,571,5038,66483,524,62,1904
2022-12-22,4392,549,4941,66670,499,67,1883
2022-12-21,4520,599,5119,67049,522,64,1627
2022-12-20,4544,614,5158,66485,515,79,1801
2022-12-19,4520,583,5103,66406,523,77,1908
2022-12-18,4388,592,4980,65955,489,81,1910
2022-12-17,4310,575,4885,66454,490,74,1849
2022-12-16,4413,594,5007,66865,528,72,1718
2022-12-15,4428,673,5101,67107,531,71,1646
2022-12-14,4508,667,5175,67202,511,74,1725
2022-12-13,4555,608,5163,66774,531,72,1800
2022-12-12,4471,615,5086,66406,527,80,1943
2022-12-11,4267,652,4919,65999,504,85,1956
2022-12-10,4171,644,4815,66451,517,83,1851
2022-12-09,4290,632,4922,66865,505,83,1793
2022-12-08,4371,672,5043,67187,506,73,1791
2022-12-07,4387,627,5014,67133,487,69,1575
2022-12-06,4321,671,4992,66862,463,81,1653
2022-12-05,4208,571,4779,66503,493,75,1821
2022-12-04,4035,577,4612,66124,468,72,1802
2022-12-03,3889,567,4456,66454,441,70,1671
2022-12-02,4039,570,4609,67097,465,77,1626
2022-12-01,3942,591,4533,67328,441,79,1603
2022-11-30,3793,605,4398,67440,408,84,1626
2022-11-29,3737,610,4347,66895,384,82,1651
2022-11-28,3532,570,4102,66397,379,71,1842
2022-11-27,3290,609,3899,65718,376,71,1936
2022-11-26,3147,580,3727,65639,367,67,1923
2022-11-25,3014,537,3551,65972,342,51,1967
2022-11-24,2883,497,3380,66531,327,48,1858
2022-11-23,2782,495,3277,66846,340,46,1759
2022-11-22,2676,524,3200,66566,346,48,1805
2022-11-21,2598,462,3060,66175,330,44,2001
2022-11-20,2494,447,2941,65899,327,39,1923
2022-11-19,2337,414,2751,66170,303,43,1823
2022-11-18,2327,430,2757,66815,318,40,1781
2022-11-17,2278,416,2694,66942,306,45,1801
2022-11-16,2187,403,2590,67023,287,38,1795
2022-11-15,2094,403,2497,66455,266,35,1898
2022-11-14,2035,395,2430,65618,260,48,2120
2022-11-13,2032,416,2448,65102,256,50,1996
2022-11-12,1942,410,2352,65941,232,48,1904
2022-11-11,1886,382,2268,66717,234,50,1864
2022-11-10,1871,395,2266,66778,220,46,1886
2022-11-09,1842,427,2269,67594,225,55,1964
2022-11-08,1855,400,2255,66357,225,46,1938
2022-11-07,1756,393,2149,66005,231,57,2150
2022-11-06,1719,395,2114,65648,218,55,2081
2022-11-05,1671,411,2082,65750,198,57,1976
2022-11-04,1704,383,2087,66536,211,53,2010
2022-11-03,1730,407,2137,67435,193,48,2048
2022-11-02,1700,410,2110,66534,196,49,1985
2022-11-01,1634,353,1987,65994,200,40,2138
2022-10-31,1592,336,1928,65670,191,41,2223
2022-10-30,1626,342,1968,65375,203,50,2182
2022-10-29,1532,354,1886,65929,185,42,2088
2022-10-28,1569,354,1923,65622,210,37,2039
2022-10-27,1599,368,1967,67370,208,47,2021
2022-10-26,1674,327,2001,66718,192,40,1983
2022-10-25,1537,311,1848,65905,198,46,2011
2022-10-24,1514,323,1837,65356,190,43,2212
2022-10-23,1558,312,1870,65266,211,41,2125
2022-10-22,1555,329,1884,65670,193,46,2074
2022-10-21,1579,320,1899,66125,186,33,2044
2022-10-20,1599,353,1952,66375,200,42,2032
2022-10-19,1617,331,1948,66653,210,33,1989
2022-10-18,1601,323,1924,65629,212,38,2060
2022-10-17,1615,322,1937,65342,218,41,2250
2022-10-16,1649,319,1968,65126,226,40,2244
2022-10-15,1649,322,1971,65618,224,47,2254
2022-10-14,1669,294,1963,65916,225,44,2100
2022-10-13,1700,290,1990,66323,230,40,2120
2022-10-12,1733,288,2021,66467,232,36,2037
2022-10-11,1759,282,2041,66430,218,25,2223
2022-10-10,1765,299,2064,65398,228,34,2271
2022-10-09,1735,313,2048,65148,220,35,2256
2022-10-08,1693,326,2019,65612,209,33,2380
2022-10-07,1755,325,2080,66168,231,29,2289
2022-10-06,1823,305,2128,66350,233,31,2173
2022-10-05,1870,313,2183,66419,247,38,2121
2022-10-04,1896,279,2175,65816,229,41,2247
2022-10-03,1894,299,2193,65191,247,27,2303
2022-10-02,1889,320,2209,65216,254,27,2279
2022-10-01,1803,286,2089,65811,231,21,2106
2022-09-30,1903,302,2205,65720,235,25,2085
2022-09-29,1930,420,2350,66171,242,27,2217
2022-09-28,2001,291,2292,66399,238,28,2160
2022-09-27,1999,337,2336,65781,243,28,2255
2022-09-26,2048,328,2376,65065,230,24,2290
2022-09-25,2064,365,2429,64707,253,29,2232
2022-09-24,2031,341,2372,65231,260,29,2032
2022-09-23,2085,375,2460,65467,253,31,2047
2022-09-22,2133,338,2471,65646,267,30,2098
2022-09-21,2115,350,2465,65913,283,37,2076
2022-09-20,2184,337,2521,65619,275,34,2141
2022-09-19,2313,342,2655,64890,272,25,2257
2022-09-18,2319,354,2673,64718,284,22,2202
2022-09-17,2348,338,2686,64941,304,25,2214
2022-09-16,2548,324,2872,65496,313,28,2208
2022-09-15,2512,337,2849,65567,311,29,2097
2022-09-14,2580,344,2924,65991,316,30,1992
2022-09-13,2689,330,3019,65408,329,33,2039
2022-09-12,2768,331,3099,64778,346,29,2148
2022-09-11,2679,320,2999,64425,338,35,2193
2022-09-10,2694,351,3045,64435,333,30,2236
2022-09-09,2875,342,3217,64855,375,34,2022
2022-09-08,2865,348,3213,64828,370,35,2027
2022-09-07,2958,364,3322,65762,380,32,2067
2022-09-06,2983,351,3334,64865,381,47,2177
2022-09-05,2875,314,3189,62588,350,38,2230
2022-09-04,2803,303,3106,61991,352,34,2151
2022-09-03,2856,302,3158,64206,372,43,2085
2022-09-02,2957,315,3272,62913,351,43,1834
2022-09-01,3004,330,3334,64527,354,33,2134
2022-08-31,3047,352,3399,64425,377,41,1942
2022-08-30,3095,337,3432,63473,363,44,2135
2022-08-29,3103,319,3422,62359,351,39,2347
2022-08-28,2944,288,3232,58411,330,30,2012
2022-08-27,3010,302,3312,60232,362,29,2333
2022-08-26,3213,308,3521,61851,377,31,2174
2022-08-25,3137,280,3417,59438,373,33,1900
2022-08-24,3146,278,3424,58533,383,34,1912
2022-08-23,3481,347,3828,66943,416,34,2271
2022-08-22,3505,329,3834,66001,418,40,2375
2022-08-21,3405,323,3728,66209,418,39,2213
2022-08-20,3395,303,3698,66478,433,36,2242
2022-08-19,3554,325,3879,67030,420,38,2222
2022-08-18,3587,360,3947,68156,428,43,2196
2022-08-17,3719,340,4059,67094,450,38,2205
2022-08-16,3779,359,4138,66823,462,34,2251
2022-08-15,3811,333,4144,66466,448,36,2408
2022-08-14,3774,335,4109,66610,439,46,2315
2022-08-13,3762,345,4107,66527,428,45,2157
2022-08-12,3941,354,4295,66957,457,41,2137
2022-08-11,3988,318,4306,66980,457,36,2182
2022-08-10,4030,379,4409,67116,484,41,2175
2022-08-09,4100,338,4438,66791,491,32,2233
2022-08-08,4228,326,4554,66414,474,35,2356
2022-08-07,4166,350,4516,66470,473,36,2222
2022-08-06,4218,353,4571,66845,472,40,2091
2022-08-05,4368,362,4730,67085,508,32,2073
2022-08-04,4435,348,4783,67135,505,34,2147
2022-08-03,4551,324,4875,67088,522,31,2181
2022-08-02,4605,367,4972,66866,543,22,2221
2022-08-01,4654,325,4979,66385,535,30,2340
2022-07-31,4539,321,4860,66613,518,37,2218
2022-07-30,4525,355,4880,66808,522,41,2187
2022-07-29,4601,389,4990,67102,552,44,2103
2022-07-28,4672,343,5015,67099,546,48,2110
2022-07-27,4749,365,5114,66992,571,36,2085
2022-07-26,4843,338,5181,66759,543,42,2184
2022-07-25,4826,308,5134,66429,516,36,2286
2022-07-24,4642,356,4998,66392,497,39,2300
2022-07-23,4635,376,5011,66451,513,46,2143
2022-07-22,4626,350,4976,66841,515,41,2239
2022-07-21,4711,362,5073,67071,552,32,2181
2022-07-20,4762,416,5178,67034,550,43,2181
2022-07-19,4790,391,5181,66885,543,38,2233
2022-07-18,4676,382,5058,66536,528,39,2299
2022-07-17,4528,378,4906,65787,513,41,2227
2022-07-16,4490,396,4886,66696,499,45,2209
2022-07-15,4489,404,4893,66767,507,40,2138
2022-07-14,4432,381,4813,66751,481,39,2123
2022-07-13,4397,385,4782,67034,487,29,2178
2022-07-12,4377,427,4804,66854,490,34,2177
2022-07-11,4277,392,4669,66367,453,40,2262
2022-07-10,4126,406,4532,66427,456,49,2192
2022-07-09,4095,406,4501,66623,492,43,2209
2022-07-08,4024,426,4450,66826,457,53,2129
2022-07-07,4009,388,4397,67001,445,38,2112
2022-07-06,3865,423,4288,66562,429,48,2238
2022-07-05,3749,348,4097,65996,417,42,2351
2022-07-04,3560,352,3912,66168,393,45,2278
2022-07-03,3496,387,3883,66259,394,51,2205
2022-07-02,3475,398,3873,66497,395,43,2084
2022-07-01,3474,407,3881,66793,392,39,2121
2022-06-30,3467,398,3865,66916,372,40,2110
2022-06-29,3519,369,3888,66896,363,32,2183
2022-06-28,3411,360,3771,66459,347,61,2286
2022-06-27,3345,369,3714,66211,339,39,2377
2022-06-26,3231,376,3607,66318,318,36,2379
2022-06-25,3177,353,3530,66562,320,30,2355
2022-06-24,3169,365,3534,66847,331,25,2248
2022-06-23,3126,333,3459,66927,325,21,2229
2022-06-22,2993,368,3361,66820,324,33,2212
2022-06-21,2905,360,3265,66374,305,36,2274
2022-06-20,2862,347,3209,66114,310,30,2372
2022-06-19,2781,322,3103,66047,295,36,2353
2022-06-18,2746,316,3062,66359,294,35,2231
2022-06-17,2762,345,3107,66547,300,44,2169
2022-06-16,2741,354,3095,66797,319,42,2220
2022-06-15,2808,358,3166,66928,310,48,2266
2022-06-14,2796,335,3131,66742,298,46,2341
2022-06-13,2762,355,3117,65983,291,48,2379
2022-06-12,2716,362,3078,66109,297,35,2311
2022-06-11,2623,353,2976,66541,299,37,2163
2022-06-10,2614,372,2986,66817,273,45,2177
2022-06-09,2687,407,3094,66889,294,50,2125
2022-06-08,2659,377,3036,66897,295,49,2140
2022-06-07,2601,374,2975,66678,300,34,2198
2022-06-06,2581,328,2909,66185,276,24,2311
2022-06-05,2461,357,2818,66187,275,37,2272
2022-06-04,2446,353,2799,66539,286,29,2179
2022-06-03,2413,340,2753,66831,280,31,2121
2022-06-02,2415,331,2746,66698,276,31,2109
2022-06-01,2329,317,2646,66513,272,26,2190
2022-05-31,2281,344,2625,65996,242,25,2297
2022-05-30,2190,343,2533,66018,272,34,2305
2022-05-29,2164,348,2512,65772,251,69,2431
2022-05-28,2101,322,2423,66229,247,65,2294
2022-05-27,2111,297,2408,66743,263,28,2033
2022-05-26,2056,316,2372,67023,244,17,2111
2022-05-25,1967,350,2317,66921,238,29,2053
2022-05-24,1961,334,2295,66491,224,28,2130
2022-05-23,1931,326,2257,66189,217,32,2253
2022-05-22,1801,346,2147,66260,239,38,2208
2022-05-21,1789,302,2091,66577,228,31,2095
2022-05-20,1780,311,2091,66815,219,32,2048
2022-05-19,1712,314,2026,66866,208,33,2077
2022-05-18,1642,292,1934,66885,203,35,2104
2022-05-17,1615,370,1985,66614,200,30,2137
2022-05-16,1527,297,1824,66211,182,28,2337
2022-05-15,1409,297,1706,67039,191,25,2254
2022-05-14,1378,283,1661,66500,174,23,2188
2022-05-13,1390,288,1678,66694,176,21,2160
2022-05-12,1339,274,1613,66951,162,18,2175
2022-05-11,1273,274,1547,66805,152,19,2334
2022-05-10,1246,251,1497,66652,148,21,2280
2022-05-09,1203,256,1459,65810,153,20,2391
2022-05-08,1190,263,1453,66248,173,20,2362
2022-05-07,1185,259,1444,66474,165,17,2187
2022-05-06,1151,274,1425,66751,162,25,2210
2022-05-05,1123,256,1379,67036,168,19,2158
2022-05-04,1083,245,1328,66936,168,23,2171
2022-05-03,1109,268,1377,66568,142,24,2220
2022-05-02,1093,257,1350,65329,143,34,2360
2022-05-01,1052,294,1346,66104,148,26,2351
2022-04-30,1037,286,1323,66366,146,26,2313
2022-04-29,1035,295,1330,66487,140,25,2257
2022-04-28,1025,345,1370,66677,130,35,2156
2022-04-27,1012,320,1332,66621,138,34,2148
2022-04-26,1008,313,1321,66456,131,32,2256
2022-04-25,950,274,1224,65979,112,26,2399
2022-04-24,967,287,1254,65339,119,27,2352
2022-04-23,966,291,1257,65929,129,34,2226
2022-04-22,969,284,1253,66146,127,35,2195
2022-04-21,966,295,1261,66746,132,36,2163
2022-04-20,970,301,1271,66686,133,41,2133
2022-04-19,972,297,1269,66407,153,31,2217
2022-04-18,964,296,1260,65608,141,29,2331
2022-04-17,963,271,1234,65526,145,20,2306
2022-04-16,949,291,1240,65995,144,28,2177
2022-04-15,995,279,1274,66415,144,30,2166
2022-04-14,1000,271,1271,66416,155,33,2232
2022-04-13,1031,275,1306,66619,152,32,2172
2022-04-12,1040,322,1362,66521,156,39,2204
2022-04-11,1053,299,1352,66019,148,41,2338
2022-04-10,1013,323,1336,65773,152,39,2294
2022-04-09,1045,302,1347,66136,162,28,2160
2022-04-08,1064,297,1361,66458,175,26,2176
2022-04-07,1098,288,1386,66689,190,25,2206
2022-04-06,1126,292,1418,66632,193,21,2199
2022-04-05,1138,282,1420,66376,202,21,2195
2022-04-04,1154,244,1398,65862,211,20,2377
2022-04-03,1130,291,1421,65775,223,20,2250
2022-04-02,1165,291,1456,66104,217,29,2161
2022-04-01,1209,280,1489,66539,222,21,2121
2022-03-31,1270,273,1543,66690,220,19,2106
2022-03-30,1352,257,1609,66759,246,16,2139
2022-03-29,1391,244,1635,69493,246,24,2216
2022-03-28,1414,259,1673,66119,264,24,2308
2022-03-27,1470,241,1711,67127,261,24,2185
2022-03-26,1512,269,1781,66622,267,31,2087
2022-03-25,1628,305,1933,66815,266,29,2055
2022-03-24,1648,284,1932,66958,290,33,2116
2022-03-23,1699,269,1968,66726,285,23,2068
2022-03-22,1774,284,2058,66607,299,22,2207
2022-03-21,1850,246,2096,66138,313,24,2258
2022-03-20,1833,246,2079,65913,305,16,2181
2022-03-19,1900,261,2161,66217,316,15,2073
2022-03-18,1960,302,2262,66849,325,23,2017
2022-03-17,2057,293,2350,66968,343,33,2027
2022-03-16,2147,278,2425,66872,384,35,2036
2022-03-15,2227,295,2522,66719,400,33,2053
2022-03-14,2263,259,2522,66033,419,32,2201
2022-03-13,2299,264,2563,66179,443,27,2239
2022-03-12,2362,266,2628,66544,459,29,2137
2022-03-11,2497,293,2790,67006,469,26,2075
2022-03-10,2638,257,2895,67046,490,32,1994
2022-03-09,2797,266,3063,67056,516,31,2000
2022-03-08,2872,291,3163,66682,536,29,2024
2022-03-07,3016,296,3312,66127,581,34,2140
2022-03-06,3139,294,3433,66251,620,37,2009
2022-03-05,3237,302,3539,66761,638,31,1902
2022-03-04,3419,331,3750,67112,652,34,1883
2022-03-03,3622,312,3934,67231,680,35,1889
2022-03-02,3824,326,4150,67214,680,38,1876
2022-03-01,3989,357,4346,66912,740,39,2015
2022-02-28,4129,321,4450,66357,772,42,2143
2022-02-27,4233,312,4545,66430,817,40,2088
2022-02-26,4419,305,4724,66812,839,28,1958
2022-02-25,4741,347,5088,67083,946,34,1843
2022-02-24,4914,362,5276,67156,960,30,1852
2022-02-23,5219,416,5635,67152,1035,30,1913
2022-02-22,5487,432,5919,66818,1054,47,1906
2022-02-21,5655,408,6063,66557,1098,46,1970
2022-02-20,5821,441,6262,66545,1149,43,1847
2022-02-19,6066,469,6535,67001,1223,39,1775
2022-02-18,6495,449,6944,67295,1300,43,1670
2022-02-17,6896,400,7296,67352,1373,45,1694
2022-02-16,7271,406,7677,67146,1438,47,1679
2022-02-15,7645,417,8062,66969,1502,51,1755
2022-02-14,7971,421,8392,66525,1564,47,1757
2022-02-13,8189,406,8595,66677,1629,48,1679
2022-02-12,8388,446,8834,67136,1677,49,1571
2022-02-11,8756,532,9288,67275,1783,45,1553
2022-02-10,9241,448,9689,67161,1841,49,1585
2022-02-09,9707,421,10128,67136,1902,57,1557
2022-02-08,10009,380,10389,69562,1958,49,1579
2022-02-07,10412,424,10836,66445,2007,50,1650
2022-02-06,10595,432,11027,66637,2101,51,1554
2022-02-05,10929,450,11379,66998,2119,49,1472
2022-02-04,11524,417,11941,67243,2226,50,1433
2022-02-03,12134,418,12552,67229,2283,39,1434
2022-02-02,12643,438,13081,67294,2366,53,1414
2022-02-01,12995,452,13447,67213,2435,51,1446
2022-01-31,13367,452,13819,66705,2494,44,1528
2022-01-30,13435,460,13895,66827,2534,46,1467
2022-01-29,13834,496,14330,67224,2548,58,1481
2022-01-28,14404,522,14926,67680,2559,42,1423
2022-01-27,14674,502,15176,67756,2585,42,1449
2022-01-26,15015,588,15603,67630,2577,55,1427
2022-01-25,15279,550,15829,67406,2609,53,1464
2022-01-24,15248,535,15783,67097,2600,56,1548
2022-01-23,15204,540,15744,66872,2602,71,1466
2022-01-22,15184,595,15779,67120,2567,73,1382
2022-01-21,15435,571,16006,67602,2541,55,1380
2022-01-20,15383,567,15950,119274,2485,59,1402
2022-01-19,15393,575,15968,118895,2467,41,1338
2022-01-18,15179,647,15826,66940,2404,61,1438
2022-01-17,14654,597,15251,66726,2311,66,1497
2022-01-16,14209,597,14806,66641,2185,58,1504
2022-01-15,13927,578,14505,66866,2144,54,1452
2022-01-14,13776,548,14324,67096,2093,66,1506
2022-01-13,13349,527,13876,66972,2054,61,1513
2022-01-12,12927,594,13521,67092,1958,71,1516
2022-01-11,12317,578,12895,66981,1903,65,1517
2022-01-10,11815,532,12347,66430,1813,56,1601
2022-01-09,11048,536,11584,66321,1710,44,1604
2022-01-08,10574,548,11122,66616,1625,46,1531
2022-01-07,10120,584,10704,66906,1565,72,1539
2022-01-06,9279,578,9857,66821,1500,56,1546
2022-01-05,8671,568,9239,66765,1430,53,1574
2022-01-04,8032,590,8622,66494,1390,55,1651
2022-01-03,7405,509,7914,66018,1280,63,1863
2022-01-02,6789,525,7314,65738,1266,63,1765
2022-01-01,6237,472,6709,66519,1200,56,1756
2021-12-31,5882,461,6343,66102,1161,48,1736
2021-12-30,5498,409,5907,66451,1116,55,1709
2021-12-29,5125,410,5535,66426,1149,46,1763
2021-12-28,4759,439,5198,66105,1032,47,1776
2021-12-27,4378,369,4747,65475,1030,41,1935
2021-12-26,4001,400,4401,65193,981,60,1979
2021-12-25,3781,397,4178,65235,947,51,1987
2021-12-24,3621,367,3988,65853,944,41,1894
2021-12-23,3683,378,4061,66447,944,50,1802
2021-12-22,3622,383,4005,66480,949,46,1708
2021-12-21,3589,373,3962,66411,937,41,1726
2021-12-20,3517,335,3852,66102,932,34,1802
2021-12-19,3523,331,3854,66094,938,33,1834
2021-12-18,3557,317,3874,66529,951,38,1672
2021-12-17,3589,326,3915,66804,929,38,1672
2021-12-16,3590,324,3914,67053,938,33,1647
2021-12-15,3614,357,3971,66920,936,35,1649
2021-12-14,3613,339,3952,66696,929,27,1725
2021-12-13,3583,347,3930,66331,955,35,1803
2021-12-12,3465,339,3804,65928,937,30,1708
2021-12-11,3445,355,3800,66662,906,41,1666
2021-12-10,3491,328,3819,67633,896,31,2423
2021-12-09,3345,306,3651,66230,847,33,1623
2021-12-08,3401,362,3763,66978,861,35,1622
2021-12-07,3356,359,3715,66652,857,40,1740
2021-12-06,3277,356,3633,66197,854,43,1901
2021-12-05,3214,328,3542,66171,853,33,1877
2021-12-04,3147,331,3478,66542,854,33,1811
2021-12-03,3220,333,3553,66789,850,39,1748
2021-12-02,3203,318,3521,66790,860,35,1748
2021-12-01,3187,343,3530,66666,866,42,1751
2021-11-30,3189,330,3519,66401,854,47,1821
2021-11-29,3229,311,3540,65669,871,43,2027
2021-11-28,3124,330,3454,65368,849,39,2038
2021-11-27,3100,330,3430,65290,832,34,2027
2021-11-26,3066,308,3374,64958,849,35,2009
2021-11-25,3060,325,3385,65725,859,28,1895
2021-11-24,3126,313,3439,66104,863,23,1842
2021-11-23,3109,291,3400,66159,852,31,1859
2021-11-22,3178,310,3488,65452,872,33,1919
2021-11-21,3174,291,3465,65369,876,26,1918
2021-11-20,3214,281,3495,65467,884,31,1791
2021-11-19,3268,273,3541,65724,906,28,1741
2021-11-18,3313,283,3596,65973,926,25,1768
2021-11-17,3409,290,3699,66291,915,35,1771
2021-11-16,3451,301,3752,66206,935,32,1866
2021-11-15,3480,288,3768,65590,937,37,2002
2021-11-14,3472,280,3752,65826,948,40,1947
2021-11-13,3464,319,3783,66203,967,35,1854
2021-11-12,3524,330,3854,66660,971,32,1808
2021-11-11,3585,323,3908,66732,989,34,1754
2021-11-10,3665,334,3999,66852,968,27,1776
2021-11-09,3683,323,4006,66601,939,31,1814
2021-11-08,3707,306,4013,66268,944,37,1905
2021-11-07,3716,335,4051,66130,933,48,1878
2021-11-06,3793,333,4126,66457,948,35,1887
2021-11-05,3854,351,4205,66768,957,35,1778
2021-11-04,3888,331,4219,66744,948,46,1809
2021-11-03,3914,343,4257,66791,962,47,1841
2021-11-02,3889,379,4268,66557,937,52,1950
2021-11-01,3865,392,4257,65577,954,46,2011
2021-10-31,3846,345,4191,65954,959,41,1873
2021-10-30,3802,384,4186,66313,969,41,1729
2021-10-29,3866,350,4216,66720,982,52,1732
2021-10-28,3816,340,4156,66826,984,32,1741
2021-10-27,3817,340,4157,66699,997,33,1817
2021-10-26,3827,345,4172,66408,986,39,1837
2021-10-25,3791,326,4117,66016,976,26,2003
2021-10-24,3673,308,3981,66062,963,39,1939
2021-10-23,3624,299,3923,66402,973,33,1851
2021-10-22,3683,337,4020,66686,979,41,1874
2021-10-21,3659,329,3988,66659,957,29,1896
2021-10-20,3637,350,3987,66448,992,40,1857
2021-10-19,3682,346,4028,66207,981,34,1929
2021-10-18,3693,338,4031,65791,991,40,2038
2021-10-17,3669,329,3998,65855,1006,39,1999
2021-10-16,3673,333,4006,66283,1027,39,1926
2021-10-15,3679,323,4002,66567,1023,47,1906
2021-10-14,3675,291,3966,66651,1024,32,1929
2021-10-13,3766,289,4055,66525,1052,35,1906
2021-10-12,3910,300,4210,66232,1079,36,1960
2021-10-11,3958,296,4254,65838,1084,24,2114
2021-10-10,3942,314,4256,65800,1100,42,1992
2021-10-09,4001,398,4399,66281,1116,32,1886
2021-10-08,4029,346,4375,66121,1122,41,1849
2021-10-07,4116,319,4435,66676,1163,35,1888
2021-10-06,4314,291,4605,66631,1205,32,1861
2021-10-05,4385,342,4727,66389,1251,38,1881
2021-10-04,4467,296,4763,65896,1260,29,1992
2021-10-03,4507,283,4790,65890,1291,29,1955
2021-10-02,4580,287,4867,66350,1320,27,1846
2021-10-01,4705,300,5005,66495,1334,46,1862
2021-09-30,4880,343,5223,66520,1382,20,1804
2021-09-29,5015,351,5366,66560,1417,35,1765
2021-09-28,5180,369,5549,66318,1444,35,1740
2021-09-27,5280,475,5755,65971,1488,30,1886
2021-09-26,5364,346,5710,66187,1551,34,1831
2021-09-25,5440,369,5809,66587,1569,31,1711
2021-09-24,5597,372,5969,66800,1577,31,1677
2021-09-23,5782,352,6134,66893,1633,26,1618
2021-09-22,5840,356,6196,66742,1664,44,1641
2021-09-21,5986,386,6372,66529,1693,50,1673
2021-09-20,6031,404,6435,66033,1713,53,1816
2021-09-19,6004,394,6398,66055,1726,36,1764
2021-09-18,6024,374,6398,66317,1753,42,1664
2021-09-17,6255,359,6614,66668,1785,44,1605
2021-09-16,6415,385,6800,67005,1812,42,1563
2021-09-15,6553,422,6975,67016,1815,53,1619
2021-09-14,6655,401,7056,66697,1837,104,1649
2021-09-13,6810,413,7223,66378,1853,42,1696
2021-09-12,6844,410,7254,66443,1870,43,1706
2021-09-11,6875,372,7247,66460,1879,36,1562
2021-09-10,7103,360,7463,66730,1929,35,1533
2021-09-09,7360,358,7718,66762,1962,33,1564
2021-09-08,7511,375,7886,66609,2009,56,1642
2021-09-07,7649,376,8025,66231,2037,51,1712
2021-09-06,7705,419,8124,66072,2016,47,1696
2021-09-05,7736,384,8120,66136,1999,48,1709
2021-09-04,7764,368,8132,66215,2008,43,1564
2021-09-03,8070,384,8454,66716,2074,29,1515
2021-09-02,8221,409,8630,66848,2092,39,1533
2021-09-01,8325,375,8700,66856,2083,45,1520
2021-08-31,8353,413,8766,66633,2096,27,1603
2021-08-30,8342,424,8766,66415,2128,44,1696
2021-08-29,8268,411,8679,66264,2077,41,1740
2021-08-28,8220,388,8608,66574,2043,46,1601
2021-08-27,8277,398,8675,66952,1986,52,1611
2021-08-26,8342,405,8747,66882,2005,41,1574
2021-08-25,8254,396,8650,66999,1978,48,1537
2021-08-24,8308,401,8709,66866,2012,64,1671
2021-08-23,8245,430,8675,66560,1991,57,1747
2021-08-22,8084,404,8488,66433,1914,54,1692
2021-08-21,7882,427,8309,66552,1878,43,1604
2021-08-20,7833,458,8291,66810,1885,44,1627
2021-08-19,7817,419,8236,66884,1841,38,1668
2021-08-18,7779,426,8205,66921,1772,57,1696
2021-08-17,7697,435,8132,66724,1717,62,1801
2021-08-16,7414,423,7837,66277,1693,53,1861
2021-08-15,7166,409,7575,66101,1637,53,1827
2021-08-14,6976,399,7375,66104,1583,46,1774
2021-08-13,6844,378,7222,66618,1588,39,1671
2021-08-12,6692,371,7063,66507,1524,44,1733
2021-08-11,6629,418,7047,66715,1504,51,1722
2021-08-10,6554,453,7007,66501,1430,49,1807
2021-08-09,6259,428,6687,66088,1370,47,1945
2021-08-08,5973,414,6387,66110,1325,45,1986
2021-08-07,5686,437,6123,66336,1258,58,1909
2021-08-06,5554,399,5953,66579,1222,44,1909
2021-08-05,5328,404,5732,66630,1153,50,1910
2021-08-04,5121,430,5551,66534,1112,41,1890
2021-08-03,4876,406,5282,66291,1081,54,1994
2021-08-02,4662,458,5120,65860,1040,51,2095
2021-08-01,4357,415,4772,65843,980,44,2096
2021-07-31,4125,436,4561,66037,931,42,2035
2021-07-30,3990,384,4374,66290,869,46,1989
2021-07-29,3725,378,4103,66340,829,46,1990
2021-07-28,3605,372,3977,66258,784,60,2042
2021-07-27,3365,403,3768,66042,770,59,2112
2021-07-26,3200,394,3594,65525,720,51,2241
2021-07-25,2981,350,3331,65478,669,42,2221
2021-07-24,2781,350,3131,65833,617,37,2119
2021-07-23,2691,360,3051,66067,594,30,1977
2021-07-22,2543,337,2880,66194,582,33,2066
2021-07-21,2405,344,2749,66189,575,40,2059
2021-07-20,2328,354,2682,65739,551,52,2435
2021-07-19,2164,283,2447,65239,552,37,2232
2021-07-18,1990,283,2273,65432,502,41,2243
2021-07-17,1927,280,2207,65495,477,38,2123
2021-07-16,1884,280,2164,65915,441,50,2038
2021-07-15,1770,307,2077,65991,403,33,2060
2021-07-14,1731,300,2031,65865,379,31,2070
2021-07-13,1648,287,1935,65564,359,26,2180
2021-07-12,1594,276,1870,65250,357,34,2330
2021-07-11,1484,281,1765,65138,341,35,2278
2021-07-10,1414,285,1699,65529,327,29,2234
2021-07-09,1381,295,1676,65555,326,23,2206
2021-07-08,1343,279,1622,65836,321,27,2247
2021-07-07,1319,250,1569,65628,318,16,2311
2021-07-06,1228,278,1506,65124,299,29,2555
2021-07-05,1153,257,1410,64816,298,29,2462
2021-07-04,1122,277,1399,65177,287,29,2368
2021-07-03,1097,274,1371,65568,288,22,2287
2021-07-02,1115,290,1405,65917,286,27,2253
2021-07-01,1071,295,1366,65928,295,22,2212
2021-06-30,1090,258,1348,65880,300,21,2244
2021-06-29,1089,261,1350,65673,307,22,2298
2021-06-28,1050,222,1272,65113,288,17,2472
2021-06-27,980,255,1235,65229,290,19,2423
2021-06-26,964,263,1227,65532,283,26,2323
2021-06-25,959,259,1218,65630,266,25,2320
2021-06-24,959,269,1228,65731,269,23,2306
2021-06-23,955,271,1226,65876,264,35,2262
2021-06-22,978,259,1237,65658,277,33,2360
2021-06-21,949,274,1223,65209,243,28,2567
2021-06-20,929,294,1223,65255,238,31,2436
2021-06-19,916,300,1216,65593,230,22,2328
2021-06-18,932,282,1214,65864,231,33,2266
2021-06-17,951,245,1196,66515,233,23,2255
2021-06-16,956,276,1232,65829,232,31,2276
2021-06-15,981,275,1256,65755,242,26,2443
2021-06-14,977,274,1251,65029,251,21,2588
2021-06-13,939,252,1191,65065,239,23,2439
2021-06-12,915,255,1170,65370,241,28,2296
2021-06-11,955,251,1206,65497,240,29,2298
2021-06-10,982,281,1263,65458,233,28,2241
2021-06-09,1001,278,1279,65549,234,27,2262
2021-06-08,1030,274,1304,65308,231,39,2390
2021-06-07,1015,263,1278,64961,228,37,2524
2021-06-06,1011,264,1275,64707,218,32,2484
2021-06-05,1035,274,1309,65120,221,32,2268
2021-06-04,1042,320,1362,65523,243,39,2256
2021-06-03,1062,275,1337,65587,260,36,2314
2021-06-02,1081,281,1362,65398,269,34,2365
2021-06-01,1060,270,1330,64968,263,36,2540
2021-05-31,1069,263,1332,64881,266,39,2566
2021-05-30,1057,271,1328,65001,259,36,2454
2021-05-29,1088,307,1395,65350,248,31,2468
2021-05-28,1110,247,1357,65725,255,31,2315
2021-05-27,1161,246,1407,65761,272,23,2229
2021-05-26,1175,249,1424,65695,284,28,2242
2021-05-25,1210,237,1447,65419,287,18,2339
2021-05-24,1222,244,1466,64881,297,26,2503
2021-05-23,1261,252,1513,65078,307,25,2437
2021-05-22,1276,280,1556,65429,306,26,2377
2021-05-21,1293,247,1540,65396,316,31,2303
2021-05-20,1326,285,1611,65593,325,26,2249
2021-05-19,1394,277,1671,65682,346,25,2254
2021-05-18,1387,270,1657,65469,342,35,2326
2021-05-17,1402,262,1664,65111,335,41,2470
2021-05-16,1379,310,1689,65051,328,36,2416
2021-05-15,1402,282,1684,65477,362,35,2333
2021-05-14,1428,295,1723,65716,346,35,2235
2021-05-13,1453,300,1753,65743,359,35,2220
2021-05-12,1502,308,1810,65855,368,39,2276
2021-05-11,1534,320,1854,65595,386,37,2283
2021-05-10,1531,312,1843,65151,353,40,2547
2021-05-09,1502,328,1830,64833,368,45,2425
2021-05-08,1546,314,1860,65453,387,48,2290
2021-05-07,1553,314,1867,65667,380,39,2232
2021-05-06,1557,318,1875,65738,379,38,2224
2021-05-05,1544,326,1870,65766,378,35,2247
2021-05-04,1555,338,1893,65304,408,37,2279
2021-05-03,1608,322,1930,64917,395,51,2489
2021-05-02,1626,315,1941,64766,385,46,2409
2021-05-01,1630,312,1942,65156,377,40,2317
2021-04-30,1681,320,2001,65567,371,47,2241
2021-04-29,1711,318,2029,65515,371,48,2295
2021-04-28,1715,353,2068,65540,401,54,2218
2021-04-27,1755,339,2094,65502,424,54,2281
2021-04-26,1776,314,2090,65027,431,47,2375
2021-04-25,1730,323,2053,64815,403,49,2361
2021-04-24,1717,335,2052,65387,402,39,2287
2021-04-23,1765,348,2113,65378,400,28,2196
2021-04-22,1757,338,2095,65238,404,42,2246
2021-04-21,1752,346,2098,65514,435,44,2299
2021-04-20,1774,342,2116,65292,437,46,2331
2021-04-19,1796,352,2148,64875,431,49,2535
2021-04-18,1779,320,2099,64876,404,42,2427
2021-04-17,1783,357,2140,65090,404,47,2274
2021-04-16,1801,344,2145,65523,407,46,2276
2021-04-15,1833,353,2186,65381,433,43,2296
2021-04-14,1865,350,2215,65578,459,51,3051
2021-04-13,1884,367,2251,65326,451,54,2324
2021-04-12,1839,336,2175,64835,476,38,2425
2021-04-11,1783,330,2113,64966,448,42,2453
2021-04-10,1799,324,2123,64974,434,35,2357
2021-04-09,1854,316,2170,65442,456,35,2328
2021-04-08,1859,298,2157,65334,475,43,2260
2021-04-07,1960,352,2312,65472,491,43,2277
2021-04-06,2021,345,2366,65248,478,49,2362
2021-04-05,1989,384,2373,64818,493,50,2401
2021-04-04,2005,381,2386,64855,507,53,2392
2021-04-03,2023,388,2411,64962,526,42,2209
2021-04-02,2054,375,2429,65279,538,38,2159
2021-04-01,2147,391,2538,65610,562,43,2157
2021-03-31,2200,383,2583,65684,576,47,2180
2021-03-30,2264,359,2623,65446,576,51,2258
2021-03-29,2257,342,2599,64846,561,52,2337
2021-03-28,2252,346,2598,64992,607,52,2353
2021-03-27,2290,363,2653,65475,600,58,2224
2021-03-26,2372,332,2704,65493,576,59,2140
2021-03-25,2379,386,2765,65695,601,50,2182
2021-03-24,2449,377,2826,65507,641,61,2148
2021-03-23,2545,442,2987,65541,620,56,2223
2021-03-22,2586,419,3005,65091,635,68,2354
2021-03-21,2605,407,3012,65175,674,60,2257
2021-03-20,2690,425,3115,65621,710,66,2101
2021-03-19,2769,428,3197,65609,731,60,2115
2021-03-18,2872,431,3303,65778,753,59,2069
2021-03-17,3002,454,3456,65774,778,72,2082
2021-03-16,3025,437,3462,65466,784,72,2218
2021-03-15,3058,398,3456,65078,827,70,2300
2021-03-14,3119,438,3557,65159,862,77,2295
2021-03-13,3130,445,3575,65557,896,63,2187
2021-03-12,3250,439,3689,65684,942,57,2092
2021-03-11,3335,477,3812,65746,966,64,2089
2021-03-10,3477,481,3958,65677,961,70,2134
2021-03-09,3625,494,4119,65449,992,72,2108
2021-03-08,3744,461,4205,64924,1028,79,2174
2021-03-07,3766,462,4228,64967,1065,71,2160
2021-03-06,3812,479,4291,65353,1100,59,2043
2021-03-05,4004,509,4513,65695,1152,69,2003
2021-03-04,4179,535,4714,65797,1190,46,2049
2021-03-03,4449,518,4967,65791,1267,60,1995
2021-03-02,4597,513,5110,65507,1335,68,2024
2021-03-01,4812,490,5302,65235,1390,62,2108
2021-02-28,4912,497,5409,65422,1439,79,2016
2021-02-27,5143,531,5674,65742,1507,78,1837
2021-02-26,5372,525,5897,65797,1578,73,1868
2021-02-25,5590,562,6152,65834,1640,85,1800
2021-02-24,5934,586,6520,65885,1708,75,1807
2021-02-23,6185,579,6764,65644,1778,64,1734
2021-02-22,6345,563,6908,65164,1822,76,1861
2021-02-21,6569,596,7165,65174,1933,77,1816
2021-02-20,6704,609,7313,65522,2003,70,1682
2021-02-19,7148,599,7747,65882,2089,79,1610
2021-02-18,7514,642,8156,65878,2207,84,1631
2021-02-17,7904,662,8566,65855,2341,86,1610
2021-02-16,8215,640,8855,65590,2439,94,1643
2021-02-15,8479,616,9095,65450,2487,117,1629
2021-02-14,8727,606,9333,65298,2562,98,1530
2021-02-13,8996,640,9636,66008,2632,101,1428
2021-02-12,9414,584,9998,66120,2731,77,1437
2021-02-11,9872,622,10494,66250,2849,81,1399
2021-02-10,10348,680,11028,66173,2933,81,1366
2021-02-09,10771,745,11516,66119,3031,96,1394
2021-02-08,11198,706,11904,65672,3164,100,1384
2021-02-07,11385,700,12085,65760,3240,73,1377
2021-02-06,11695,781,12476,66094,3260,79,1300
2021-02-05,12345,792,13137,66208,3391,88,1286
2021-02-04,12863,809,13672,66400,3432,95,1318
2021-02-03,13277,861,14138,66341,3637,119,1269
2021-02-02,13766,812,14578,66332,3667,105,1278
2021-02-01,14221,778,14999,66011,3797,97,1284
2021-01-31,14443,769,15212,66290,3857,92,1290
2021-01-30,14856,820,15676,66478,3944,103,1194
2021-01-29,15296,828,16124,66462,4016,87,1184
2021-01-28,15705,876,16581,66570,4145,87,1187
2021-01-27,16251,892,17143,66702,4196,87,1199
2021-01-26,16839,871,17710,66404,4284,91,1186
2021-01-25,17236,803,18039,66280,4315,69,1166
2021-01-24,17432,915,18347,66145,4395,80,1168
2021-01-23,17810,828,18638,66453,4459,83,1116
2021-01-22,18442,851,19293,66617,4534,107,1124
2021-01-21,18985,870,19855,66657,4627,91,1095
2021-01-20,19537,871,20408,66764,4670,76,1030
2021-01-19,19979,835,20814,66543,4682,76,1159
2021-01-18,20062,880,20942,66442,4693,100,1177
2021-01-17,20172,830,21002,66413,4719,107,1113
2021-01-16,20323,820,21143,66577,4725,95,1070
2021-01-15,20722,857,21579,67462,4750,96,1128
2021-01-14,20999,858,21857,67613,4743,88,1111
2021-01-13,21282,928,22210,67730,4770,108,1094
2021-01-12,21654,896,22550,67701,4829,100,1183
2021-01-11,21747,918,22665,67539,4854,108,1229
2021-01-10,21664,965,22629,67296,4868,103,1242
2021-01-09,21647,866,22513,67562,4863,102,1159
2021-01-08,21754,846,22600,67527,4854,85,1173
2021-01-07,21855,981,22836,68920,4812,93,1147
2021-01-06,21938,915,22853,68864,4742,99,1210
2021-01-05,21923,898,22821,68974,4636,95,1311
2021-01-04,21597,888,22485,68621,4634,100,1319
2021-01-03,21128,875,22003,68334,4584,87,1337
2021-01-02,20690,820,21510,68379,4509,104,1324
2021-01-01,20344,859,21203,68483,4531,75,1335
2020-12-31,20540,893,21433,68816,4524,93,1291
2020-12-30,20640,824,21464,68975,4432,86,1237
2020-12-29,20612,821,21433,68762,4389,89,1270
2020-12-28,20390,850,21240,68288,4308,82,1428
2020-12-27,19766,876,20642,68014,4228,132,1385
2020-12-26,19237,822,20059,67768,4123,91,1475
2020-12-25,18943,854,19797,67817,4043,88,1392
2020-12-24,18937,834,19771,68184,3949,86,1387
2020-12-23,18875,896,19771,68419,3962,107,1302
2020-12-22,18448,913,19361,68454,3827,128,1373
2020-12-21,17843,1118,18961,68233,3755,106,1399
2020-12-20,17190,1169,18359,67919,3644,112,1429
2020-12-19,16843,907,17750,68567,3614,96,1353
2020-12-18,16465,933,17398,68711,3523,97,1284
2020-12-17,16019,946,16965,68637,3447,106,1234
2020-12-16,15431,995,16426,68514,3280,112,1260
2020-12-15,14939,947,15886,68470,3188,109,1331
2020-12-14,14283,915,15198,68081,3081,112,1466
2020-12-13,13635,943,14578,68012,2967,111,1424
2020-12-12,13047,913,13960,68179,2820,117,1412
2020-12-11,12444,966,13410,68543,2752,114,1419
2020-12-10,12013,927,12940,68478,2669,104,1450
2020-12-09,11497,980,12477,68189,2621,89,1487
2020-12-08,11012,953,11965,68254,2506,121,1566
2020-12-07,10567,944,11511,67843,2417,109,1679
2020-12-06,10070,928,10998,67886,2360,110,1714
2020-12-05,9740,884,10624,68093,2281,112,1567
2020-12-04,9453,833,10286,68481,2182,83,1628
2020-12-03,9065,883,9948,69401,2152,96,1673
2020-12-02,8831,871,9702,69419,2066,81,1731
2020-12-01,8517,848,9365,69207,2006,115,1810
2020-11-30,8240,809,9049,68517,1890,110,1937
2020-11-29,7787,791,8578,68286,1812,107,2000
2020-11-28,7415,783,8198,68396,1711,112,1990
2020-11-27,6972,712,7684,68145,1638,125,2019
2020-11-26,6647,741,7388,68592,1595,131,1904
2020-11-25,6449,748,7197,68809,1512,105,1927
2020-11-24,6188,861,7049,68937,1433,118,1958
2020-11-23,5844,797,6641,68381,1397,117,2126
2020-11-22,5459,795,6254,68580,1333,122,2035
2020-11-21,5199,748,5947,68836,1282,108,1954
2020-11-20,4989,756,5745,69043,1227,105,1921
2020-11-19,4755,742,5497,69295,1240,92,1918
2020-11-18,4523,796,5319,69276,1155,98,1926
2020-11-17,4309,769,5078,68974,1148,110,1973
2020-11-16,4118,767,4885,68288,1086,120,2266
2020-11-15,3852,707,4559,68416,1031,100,2165
2020-11-14,3683,771,4454,68698,1001,93,2142
2020-11-13,3531,681,4212,68921,955,69,2079
2020-11-12,3399,739,4138,68963,931,100,2086
2020-11-11,3300,702,4002,68980,913,97,2112
2020-11-10,3224,763,3987,68815,889,117,2174
2020-11-09,3083,716,3799,68182,859,125,2370
2020-11-08,3001,667,3668,68032,839,102,2271
2020-11-07,2902,652,3554,68511,811,99,2200
2020-11-06,2821,635,3456,68755,807,94,2159
2020-11-05,2765,706,3471,68585,822,101,2220
2020-11-04,2712,750,3462,68361,814,108,2212
2020-11-03,2669,741,3410,68298,779,122,2262
2020-11-02,2602,668,3270,67660,743,97,2520
2020-11-01,2537,704,3241,67540,708,115,2456
2020-10-31,2474,719,3193,67799,698,93,2402
2020-10-30,2525,687,3212,68010,681,90,2227
2020-10-29,2430,718,3148,68183,666,106,2329
2020-10-28,2358,725,3083,68233,657,111,2318
2020-10-27,2342,656,2998,68070,663,107,2360
2020-10-26,2334,666,3000,67603,659,115,2576
2020-10-25,2281,710,2991,67413,610,102,2486
2020-10-24,2254,715,2969,67803,615,107,2420
2020-10-23,2336,671,3007,68348,636,108,2306
2020-10-22,2338,673,3011,68228,650,104,2412
2020-10-21,2351,700,3051,68451,652,106,2399
2020-10-20,2348,729,3077,67995,660,103,2373
2020-10-19,2291,813,3104,66797,657,124,3079
2020-10-18,2241,761,3002,66713,660,98,2947
2020-10-17,2286,734,3020,66986,624,103,2883
2020-10-16,2234,761,2995,67813,644,99,2823
2020-10-15,2245,790,3035,67412,615,98,2817
2020-10-14,2239,839,3078,67457,600,106,2866
2020-10-13,2229,886,3115,67351,622,131,2860
2020-10-12,2226,834,3060,66745,626,122,3012
2020-10-11,2196,874,3070,66476,604,132,2919
2020-10-10,2209,894,3103,67039,612,123,2831
2020-10-09,2264,820,3084,67672,612,120,2734
2020-10-08,2310,876,3186,67758,635,107,2718
2020-10-07,2328,858,3186,67669,652,102,2772
2020-10-06,2323,881,3204,67458,673,124,2811
2020-10-05,2344,831,3175,66925,681,128,2955
2020-10-04,2291,855,3146,66853,681,124,3006
2020-10-03,2283,846,3129,66920,664,123,2838
2020-10-02,2287,792,3079,67210,673,114,2772
2020-10-01,2339,827,3166,67308,679,117,2776
2020-09-30,2369,836,3205,67430,685,132,2779
2020-09-29,2393,874,3267,67271,697,133,2822
2020-09-28,2392,831,3223,66972,693,135,2996
2020-09-27,2317,843,3160,66679,714,117,2898
2020-09-26,2331,798,3129,66920,733,134,2824
2020-09-25,2385,818,3203,67263,738,124,2717
2020-09-24,2474,833,3307,67061,753,146,2686
2020-09-23,2578,906,3484,67183,774,140,2740
2020-09-22,2617,940,3557,67092,783,122,2813
2020-09-21,2632,888,3520,66560,799,124,2902
2020-09-20,2573,886,3459,66616,811,149,2899
2020-09-19,2598,834,3432,66797,807,118,2829
2020-09-18,2663,847,3510,67181,839,131,2714
2020-09-17,2676,894,3570,67057,836,129,2684
2020-09-16,2708,913,3621,66965,860,137,2696
2020-09-15,2821,864,3685,67066,875,157,2745
2020-09-14,2887,848,3735,66431,902,142,2914
2020-09-13,2841,824,3665,66571,921,119,2831
2020-09-12,2869,872,3741,66668,932,124,2691
2020-09-11,2990,878,3868,67151,970,150,2602
2020-09-10,3142,881,4023,66974,1023,149,2559
2020-09-09,3288,937,4225,66847,1040,144,2584
2020-09-08,3354,1071,4425,66444,1072,161,2741
2020-09-07,3321,986,4307,65950,1080,137,2677
2020-09-06,3308,977,4285,66033,1120,124,2656
2020-09-05,3336,890,4226,66368,1091,110,2611
2020-09-04,3413,829,4242,66735,1116,126,2579
2020-09-03,3513,888,4401,66794,1107,128,2549
2020-09-02,3604,967,4571,66797,1119,151,2548
2020-09-01,3773,1078,4851,67003,1197,142,2612
2020-08-31,3849,1020,4869,66574,1194,158,2794
2020-08-30,3878,951,4829,66517,1223,123,2684
2020-08-29,3940,1003,4943,66580,1266,130,2546
2020-08-28,4072,991,5063,66984,1282,129,2495
2020-08-27,4205,1062,5267,67329,1329,148,2465
2020-08-26,4293,1104,5397,67368,1349,143,2523
2020-08-25,4365,1172,5537,66897,1367,140,2512
2020-08-24,4424,1137,5561,66112,1388,152,2647
2020-08-23,4467,1151,5618,66322,1397,152,2568
2020-08-22,4561,1104,5665,66841,1441,141,2433
2020-08-21,4659,1214,5873,67466,1513,162,2391
2020-08-20,4772,1267,6039,67142,1533,173,2394
2020-08-19,4890,1322,6212,70020,1557,150,2467
2020-08-18,5058,1421,6479,66838,1590,171,2477
2020-08-17,5061,1299,6360,66392,1606,195,2554
2020-08-16,4975,1357,6332,66617,1589,222,2512
2020-08-15,5027,1282,6309,66634,1619,201,2476
2020-08-14,5112,1215,6327,66436,1631,181,2501
2020-08-13,5189,1175,6364,67730,1684,166,2625
2020-08-12,5236,1188,6424,65868,1672,154,2383
2020-08-11,5442,1205,6647,65571,1699,174,2522
2020-08-10,5549,1210,6759,64962,1725,160,2595
2020-08-09,5596,1174,6770,65027,1727,152,2574
2020-08-08,5636,1213,6849,65259,1731,160,2564
2020-08-07,5746,1210,6956,65111,1868,170,2402
2020-08-06,5932,1345,7277,65856,1798,180,2464
2020-08-05,6069,1416,7485,66343,1828,198,2589
2020-08-04,6184,1368,7552,65388,1828,177,2579
2020-08-03,6302,1328,7630,65548,1892,190,2707
2020-08-02,6399,1246,7645,65466,1909,160,2595
2020-08-01,6362,1399,7761,66229,1940,179,2592
2020-07-31,6477,1295,7772,68700,1966,154,2426
2020-07-30,6630,1367,7997,68708,2003,160,2487
2020-07-29,6753,1445,8198,69222,2029,191,2548
2020-07-28,6939,1500,8439,68595,2012,197,2711
2020-07-27,6896,1421,8317,66080,1975,223,2846
2020-07-26,6935,1484,8419,68072,2012,209,2748
2020-07-25,6912,1468,8380,66879,1993,206,2682
2020-07-24,6895,1554,8449,61997,2019,236,2572
2020-07-23,6952,1619,8571,61078,2002,218,2614
2020-07-22,6825,1512,8337,56140,1978,218,1819
2020-07-21,7170,1650,8820,80459,2058,226,3668
2020-07-20,7091,1590,8681,78677,2006,220,4045
2020-07-19,6921,1498,8419,79300,1943,214,4057
2020-07-18,6899,1499,8398,80599,1921,186,3985
2020-07-17,6894,1608,8502,80873,1930,195,3884
2020-07-16,6808,1642,8450,80955,1941,212,3802
2020-07-15,6777,1586,8363,80888,1897,223,3797
2020-07-14,6786,1567,8353,80946,1907,203,3798
2020-07-13,6745,1400,8145,80776,1886,197,4008
2020-07-12,6485,1410,7895,80753,1833,188,4178
2020-07-11,6322,1532,7854,80944,1806,214,3787
2020-07-10,6357,1547,7904,81182,1806,215,3944
2020-07-09,6171,1725,7896,81136,1777,228,3916
2020-07-08,6126,1695,7821,81018,1752,205,3795
2020-07-07,6100,1605,7705,80898,1753,223,3908
2020-07-06,5989,1510,7499,80846,1740,244,3925
2020-07-05,5790,1488,7278,80170,1706,231,3882
2020-07-04,5669,1480,7149,80259,1711,196,3871
2020-07-03,5595,1497,7092,80484,1682,206,3555
2020-07-02,5506,1518,7024,78103,1650,221,3497
2020-07-01,5355,1457,6812,75548,1676,258,3451
2020-06-30,5196,1416,6612,78892,1617,242,3580
2020-06-29,5077,1389,6466,78532,1528,223,3730
2020-06-28,4776,1403,6179,78481,1465,221,3717
2020-06-27,4577,1379,5956,78710,1385,217,3621
2020-06-26,4494,1296,5790,78951,1379,183,3684
2020-06-25,4380,1259,5639,78809,1364,206,3632
2020-06-24,4240,1282,5522,78972,1306,217,3790
2020-06-23,4095,1304,5399,78941,1268,219,4034
2020-06-22,3868,1197,5065,78427,1225,196,4178
2020-06-21,3702,1102,4804,78821,1199,213,4120
2020-06-20,3574,1105,4679,78923,1163,203,4045
2020-06-19,3494,1088,4582,79040,1145,187,3898
2020-06-18,3428,1159,4587,79025,1128,201,3879
2020-06-17,3439,1145,4584,78530,1119,179,3530
2020-06-16,3421,1101,4522,79073,1109,209,3770
2020-06-15,3335,1127,4462,78937,1069,203,3928
2020-06-14,3103,1220,4323,78953,1053,217,3780
2020-06-13,3092,1155,4247,78996,1076,204,3730
2020-06-12,3191,1220,4411,79023,1109,204,3689
2020-06-11,3222,1258,4480,79040,1101,209,3648
2020-06-10,3177,1357,4534,78848,1073,252,3741
2020-06-09,3240,1479,4719,78777,1090,236,3728
2020-06-08,3257,1326,4583,78876,1103,242,3926
2020-06-07,3184,1322,4506,78156,1079,222,3791
2020-06-06,3138,1387,4525,78904,1068,220,3752
2020-06-05,3181,1345,4526,78939,1077,238,3719
2020-06-04,3142,1483,4625,79087,1083,250,3686
2020-06-03,3109,1346,4455,78941,1058,221,3676
2020-06-02,3090,1368,4458,78825,1079,234,3676
2020-06-01,3038,1355,4393,78684,1054,242,4181
2020-05-31,2973,1285,4258,78683,1053,220,3860
2020-05-30,2940,1391,4331,78651,1067,257,3754
2020-05-29,2928,1287,4215,78886,1042,231,3696
2020-05-28,3016,1398,4414,78883,1078,250,3742
2020-05-27,3091,1438,4529,78851,1092,233,3865
2020-05-26,3114,1430,4544,78678,1095,312,4231
2020-05-25,3065,1339,4404,78610,1084,308,4232
2020-05-24,3015,1291,4306,78609,1062,239,3813
2020-05-23,2980,1320,4300,78704,1071,244,3767
2020-05-22,3024,1318,4342,78825,1079,233,3719
2020-05-21,3007,1755,4762,78767,1050,267,3710
2020-05-20,3048,1687,4735,78891,1051,259,3811
2020-05-19,3047,1634,4681,78812,1068,277,3805
2020-05-18,3073,1290,4363,78833,1076,231,3925
2020-05-17,3037,1354,4391,78376,1076,249,3846
2020-05-16,3025,1266,4291,78507,1069,224,3704
2020-05-15,3126,1298,4424,78600,1079,234,3710
2020-05-14,3157,1362,4519,78776,1067,257,3811
2020-05-13,3261,1394,4655,78644,1099,225,3840
2020-05-12,3301,1244,4545,78319,1075,239,3833
2020-05-11,3284,1260,4544,78116,1078,271,3899
2020-05-10,3248,1301,4549,77984,1093,236,3868
2020-05-09,3218,1337,4555,78174,1097,231,3717
2020-05-08,3282,1256,4538,78196,1115,234,3665
2020-05-07,3250,1264,4514,76338,1118,224,3741
2020-05-06,3319,1241,4560,76381,1125,249,3988
2020-05-05,3334,1347,4681,74808,1140,275,3893
2020-05-04,3369,1253,4622,70226,1157,231,4024
2020-05-03,3284,1332,4616,69332,1179,285,3969
2020-05-02,3318,1416,4734,68946,1169,299,3922
2020-05-01,3423,1299,4722,63899,1178,255,3941
2020-04-30,3428,1278,4706,63244,1192,242,4143
2020-04-29,3497,1484,4981,68797,1192,281,4010
2020-04-28,3495,1516,5011,67497,1186,326,4024
2020-04-27,3455,1528,5283,67190,1181,304,4271
2020-04-26,3372,1506,4878,67105,1185,314,4352
2020-04-25,3324,1604,4928,67131,1184,289,4527
2020-04-24,3343,1504,4847,62518,1198,260,4042
2020-04-23,3344,1536,4880,62310,1216,305,3625
2020-04-22,3343,1586,4901,53258,1204,327,3407
2020-04-21,3357,1627,4984,43661,1219,332,2778
2020-04-20,3365,1521,NULL,NULL,1241,261,2185
2020-04-19,3257,1417,NULL,NULL,1196,284,2212
2020-04-18,3196,1535,NULL,NULL,1163,294,2229
2020-04-17,3221,1715,NULL,NULL,1173,316,2103
2020-04-16,3180,1712,NULL,NULL,1174,310,2127
2020-04-15,3141,1890,NULL,NULL,1191,377,2068
2020-04-14,3171,1894,NULL,NULL,1175,368,2196
2020-04-13,3124,2039,NULL,NULL,1177,375,2182
2020-04-12,3015,2033,NULL,NULL,1178,374,2052
2020-04-11,2917,2317,NULL,NULL,1145,394,2309
2020-04-10,2846,2221,NULL,NULL,1145,420,2327
2020-04-09,2897,2339,NULL,NULL,1145,446,2135
2020-04-08,2825,2803,NULL,NULL,1132,530,2238
2020-04-07,2714,3078,NULL,NULL,1154,522,2110
2020-04-06,2611,2796,NULL,NULL,1108,522,2219
2020-04-05,2509,2967,NULL,NULL,1085,575,2054
2020-04-04,2383,3183,NULL,NULL,1035,559,2951
2020-04-03,2285,3227,NULL,NULL,1003,583,2910
2020-04-02,2176,3408,NULL,NULL,896,582,2720
2020-04-01,1916,3478,NULL,NULL,810,617,2772
2020-03-31,1855,3773,NULL,NULL,774,642,2745
2020-03-30,1624,3528,NULL,NULL,662,594,2937
2020-03-29,1306,2739,NULL,NULL,544,474,2423
